-.-.-.-.-.-.-
-.-.-.P.G.-.-
-.-.-.-.-.-.W
-.-.-.-.-.-.-
-.-.-.-.-.G.-
-.-.-.-.P.A.-
-.-.-.W.-.-.-.