10
 - . S . - . B . P . B . - . - . - . -
 S . W . S . - . B . - . - . G . - . -
 - . S . - . - . - . - . - . - . - . -
 - . - . - . - . - . - . - . - . - . -
 - . - . - . - . - . - . - . - . - . -
 - . - . - . - . - . - . - . - . - . -
 - . - . - . - . - . - . B . - . - . -
 - . G . - . - . - . B . P . B . - . -
 - . - . - . - . - . - . B . - . - . B
 A . - . - . - . - . - . - . - . B . P


