10
 - . S . - . - . - . - . - . - . - . -
 S . W . S . - . - . - . - . G . - . -
 - . S . - . - . - . - . - . - . - . -
 - . - . - . - . - . - . - . - . - . -
 - . - . - . - . - . - . - . - . - . -
 - . - . - . - . - . - . - . - . - . -
 - . - . - . - . - . - . B . - . - . -
 - . G . - . - . - . B . P . B . - . -
 - . - . - . - . - . - . B . - . - . B
 A . - . - . - . - . - . - . - . B . P


