10
 - . - . G . - . G . P . - . - . - . - 
 - . W . - . - . - . - . - . G . - . -
 G . - . G . - . - . - . - . - . - . -
 - . - . - . - . - . - . - . - . - . -
 - . - . - . - . - . - . - . - . - . -
 - . - . - . - . - . - . G . - . - . G
 - . P . - . - . - . - . - . - . - . -
 P . - . P . - . - . - . P . - . - . -
 - . - . - . G . - . - . - . - . - . - 
 A . - . W . - . - . - . G . - . - . P


