10
 - . S . G . B . P . B . - . - . - . -
 S . W . S . - . B . - . - . G . - . -
 G . S . G . - . - . - . - . - . - . -
 - . - . - . - . - . - . - . - . - . -
 - . - . - . - . - . - . - . - . - . -
 - . B . - . - . - . - . G . - . - . G
 B . P . B . - . - . - . B . - . - . -
 P . B . P . B . - . B . P . B . - . -
 B . - . S, B . - . - . - . B . - . - . B
 A . S . W . S . - . - . G . - . B . P


