6
W.-.P.P.-.-
-.-.-.-.W.-
-.-.-.-.G.P
W.G.-.A.-.P
-.G.P.-.W.G
-.-.-.-.P.-

