6
W.-.P.P.-.-
-.-.-.-.W.-
-.-.-.-.G.P
G.W.-.A.-.P
-.G.P.-.W.G
-.-.-.-.P.-

