6
W.-.P.P.-.-
-.-.-.-.W.-
-.-.-.-.G.P
G.-.W.A.P.P
-.G.P.-.W.G
-.-.-.-.-.-

