10
A.G.G.W.-.-.-.-.-.-
G.G.-.-.-.-.-.-.-.-
-.-.P.-.-.P.G.P.-.-
P.-.P.-.-.-.-.-.-.-
-.P.-.-.-.-.-.P.P.-
-.-.P.-.-.-.W.P.-.P
W.G.W.P.-.-.-.P.P.P
G.P.-.-.-.-.-.-.-.-
-.-.-.-.-.P.-.W.P.G
P.W.P.W.P.W.P.W.-.P