10
A.G.G.-.-.-.-.-.-.-
G.G.-.-.-.-.-.-.-.-
-.-.P.-.-.P.G.P.-.-
P.-.P.-.-.-.-.-.-.-
-.P.-.-.-.-.-.P.P.-
-.-.P.-.-.-.-.P.-.P
W.G.W.P.-.-.-.P.P.P
G.P.-.-.-.-.-.-.-.-
-.-.-.-.-.P.-.-.W.G
-.-.-.-.P.W.P.W.-.P